,reportedCurrency,grossProfit,totalRevenue,costOfRevenue,costofGoodsAndServicesSold,operatingIncome,sellingGeneralAndAdministrative,researchAndDevelopment,operatingExpenses,investmentIncomeNet,netInterestIncome,interestIncome,interestExpense,nonInterestIncome,otherNonOperatingIncome,depreciation,depreciationAndAmortization,incomeBeforeTax,incomeTaxExpense,interestAndDebtExpense,netIncomeFromContinuingOperations,comprehensiveIncomeNetOfTax,ebit,ebitda,netIncome,Quarter
0,USD,1476000000,1965800000,1502000000,499100000,53600000,974500000,447900000,1422400000,None,-2800000,85300000,2800000,1968600000,5900000,None,28400000,135500000,-1611400000,2800000,1746900000,1833400000,138300000,166700000,1746900000,2024Q1
1,USD,1405300000,1880300000,1278300000,472800000,215200000,780600000,409500000,1190100000,None,-2900000,71200000,2900000,1883200000,-6000000,None,24900000,282600000,88400000,2900000,194200000,144400000,285500000,310400000,194200000,2023Q4
2,USD,1446500000,1944800000,1310600000,506800000,253500000,778600000,414400000,1193000000,None,-5700000,72500000,5700000,1950500000,-1000000,None,25200000,316500000,88800000,5700000,227700000,205200000,322200000,347400000,227700000,2023Q3
3,USD,1246100000,1710900000,1254300000,474800000,78700000,753700000,413700000,1167400000,None,-7800000,65900000,7800000,1718700000,-3600000,None,25800000,131000000,23200000,7800000,107800000,98200000,138800000,164600000,107800000,2023Q2
4,USD,1188900000,1640900000,1235900000,466200000,39900000,744900000,404100000,1149000000,None,-6900000,56600000,6900000,1647800000,2100000,None,24800000,84400000,200000,6900000,84200000,184200000,91300000,116100000,84200000,2023Q1
5,USD,1101500000,1561000000,1205500000,461900000,15200000,714500000,371800000,1086300000,None,-6800000,29400000,6800000,1567800000,-7800000,None,29100000,34400000,14400000,6800000,20000000,-35500000,41200000,70300000,20000000,2022Q4
6,USD,1058200000,1545400000,1202900000,492300000,15400000,679000000,363800000,1042800000,None,-6900000,None,6900000,1552300000,-4800000,None,31600000,17300000,14000000,6900000,3300000,6000000,24200000,55800000,3300000,2022Q3
7,USD,946200000,1379900000,1110700000,440500000,-47600000,638400000,355400000,993800000,None,-6800000,None,6800000,1386700000,-4200000,None,31800000,-52500000,20700000,6800000,-73200000,-101300000,-45700000,-13900000,-73200000,2022Q2
8,USD,911600000,1310100000,1063500000,405300000,-73900000,626500000,359000000,985500000,None,-6800000,None,6800000,1316900000,-300000,None,31700000,-80800000,12700000,6800000,-93500000,-112400000,-74000000,-42300000,-93500000,2022Q1
9,USD,866800000,1240500000,1022400000,380600000,-82700000,610000000,339500000,949500000,None,-6900000,None,6900000,1247400000,900000,None,31800000,-91200000,12400000,6900000,-103600000,-105000000,-84300000,-52500000,-103600000,2021Q4
10,USD,860400000,1175000000,986100000,358900000,-60400000,595500000,325300000,920800000,None,-41400000,1500000,41400000,1216400000,900000,None,31700000,-102300000,17000000,41400000,-119300000,-132800000,-60900000,-29200000,-119300000,2021Q3
11,USD,743300000,1032000000,906100000,330600000,-110400000,542700000,311000000,853700000,None,-41000000,1800000,41000000,1073000000,100000,None,32800000,-150400000,-5300000,41000000,-145100000,-151400000,-109400000,-76600000,-145100000,2021Q2
12,USD,709300000,972500000,868700000,307600000,-88800000,531400000,266700000,798100000,None,-40700000,2300000,40700000,1013200000,900000,None,29700000,-130000000,12300000,40700000,-142300000,-135600000,-89300000,-59600000,-142300000,2021Q1
13,USD,668200000,907900000,776700000,277800000,-44500000,475300000,237400000,712700000,None,-40200000,2900000,40200000,948100000,-2600000,None,23600000,-82300000,9900000,40200000,-92200000,-99500000,-42100000,-18500000,-92200000,2020Q4
14,USD,660000000,919000000,752300000,290400000,-17800000,461900000,215900000,677800000,None,-31400000,3400000,31400000,950400000,800000,None,23200000,-48400000,10500000,31400000,-58900000,-46400000,-17000000,6200000,-58900000,2020Q3
15,USD,611100000,850200000,748900000,258300000,-56500000,471300000,196300000,667600000,None,-19400000,8300000,19400000,869600000,-400000,None,19300000,-67800000,7000000,19400000,-74800000,-75000000,-48400000,-29100000,-74800000,2020Q2
16,USD,583600000,795300000,702100000,233100000,-52900000,451100000,185400000,636500000,None,-19000000,13900000,19000000,814300000,-700000,None,17900000,-61100000,12600000,19000000,-73700000,-74900000,-42100000,-24200000,-73700000,2020Q1
17,USD,554200000,753400000,670100000,217700000,-51800000,435500000,170500000,606000000,None,-18900000,15800000,18900000,772300000,0,None,16900000,-54500000,5100000,18900000,-59600000,-56500000,-35600000,-18700000,-59600000,2019Q4
18,USD,588400000,785800000,657000000,217400000,-9900000,439600000,158700000,598300000,None,-20000000,18100000,20000000,805800000,16200000,None,15100000,-13700000,7100000,20000000,-20800000,-17300000,6300000,21400000,-20800000,2019Q3
19,USD,521700000,705900000,620900000,204900000,-18700000,401300000,139100000,540400000,None,-20600000,2400000,20600000,726500000,18200000,None,14700000,-21100000,-900000,20600000,-20200000,-17600000,-500000,14200000,-20200000,2019Q2
20,USD,508600000,689400000,590700000,202600000,6600000,373700000,128300000,502000000,None,-20600000,None,20600000,710000000,16000000,None,14400000,2000000,4600000,20600000,-2600000,6600000,22600000,37000000,-2600000,2019Q1
21,USD,472500000,631100000,584100000,183500000,-32100000,391200000,113400000,504600000,None,-22700000,None,22700000,653800000,13000000,None,9400000,-41800000,-3500000,24900000,-38300000,-40900000,-19100000,-9700000,-38300000,2018Q4
22,USD,474000000,677300000,539200000,184500000,17100000,354500000,110300000,456900000,None,-10400000,None,10400000,658500000,10200000,None,7100000,16900000,9900000,10400000,-2300000,3800000,27300000,34400000,7000000,2018Q3
23,USD,407800000,560600000,522900000,159900000,-45300000,359200000,99600000,453100000,None,-6500000,None,6500000,570400000,8600000,None,3800000,-43200000,-2800000,6500000,-46700000,-46400000,-36700000,-32900000,-40400000,2018Q2
24,USD,386200000,536000000,477600000,159400000,-22500000,318300000,96600000,408700000,None,-6400000,None,6400000,544400000,4900000,None,2700000,-24000000,1600000,6400000,-34900000,-25800000,-17600000,-14900000,-25600000,2018Q1
25,USD,360500000,499200000,481000000,141300000,-53500000,324200000,94200000,414000000,None,-6300000,None,6300000,501200000,4800000,None,2700000,-55000000,8200000,6300000,-64000000,-66800000,-48700000,-46000000,-63200000,2017Q4
26,USD,370600000,527400000,449100000,138500000,-27300000,310600000,87300000,397900000,None,-6200000,None,6200000,None,2900000,None,2700000,-30600000,7600000,6200000,-38200000,-23800000,-24400000,-21700000,-38200000,2017Q3
27,USD,308100000,425600000,397400000,123700000,-49100000,271200000,86000000,357200000,None,-6200000,None,6200000,None,2100000,None,2500000,-53200000,7700000,6200000,-60900000,-60000000,-47000000,-44500000,-60900000,2017Q2
28,USD,309400000,416500000,387100000,113200000,-54400000,273900000,89900000,363800000,None,-6100000,None,6100000,None,2700000,None,14400000,-57800000,2800000,6100000,-60600000,-63800000,-51700000,-37300000,-60600000,2017Q1
29,USD,296900000,392100000,363400000,101200000,-49000000,262100000,84200000,345900000,None,-6000000,None,6000000,None,2500000,None,13600000,-52500000,4400000,6000000,-61800000,-59800000,-46500000,-33800000,-56900000,2016Q4
30,USD,299100000,418200000,369700000,101700000,-22700000,268000000,76500000,321800000,None,-6000000,None,6000000,None,2700000,None,2300000,-26000000,5400000,6000000,-54500000,-31000000,-20000000,-17700000,-31400000,2016Q3
31,USD,250900000,340000000,330400000,94900000,-52500000,235500000,74000000,303400000,None,-5800000,None,5800000,None,1000000,None,2300000,-57300000,6800000,5800000,-70200000,-62800000,-51500000,-49200000,-64100000,2016Q2
32,USD,240500000,328900000,316000000,94200000,-50100000,221800000,74000000,290600000,None,-5800000,None,5800000,None,2500000,None,10300000,-53400000,3900000,5800000,-62500000,-57600000,-47600000,-42500000,-57300000,2016Q1
33,USD,218000000,291400000,268300000,79200000,-32000000,189100000,59700000,250000000,None,-5800000,None,5800000,None,2200000,None,9200000,-35600000,4300000,5800000,-38700000,-40200000,-29800000,-19400000,-39900000,2015Q4
34,USD,209600000,300586000,265323000,74300000,-34500000,191005000,53100000,244100000,None,-5666000,-66000,5600000,None,-346000,None,2220000,-40600000,5400000,5666000,-45971000,-12500000,-35000000,-32780000,-46000000,2015Q3
35,USD,169800000,228541000,224381000,64400000,-36700000,158015000,48400000,206500000,None,-5631000,69000,5700000,None,-55000,None,1971000,-42400000,3500000,5631000,-45935000,-46000000,-36700000,-34729000,-45900000,2015Q2
36,USD,158300000,212116000,211178000,59400000,-38500000,149898000,47000000,196800000,None,-5539000,-39000,5500000,None,344000,None,1955000,-43700000,-700000,5539000,-43008000,-42800000,-38200000,-36245000,-43000000,2015Q1
37,USD,138900000,186857000,180558000,53400000,-23800000,125343000,37300000,162700000,None,-5489000,11000,5500000,None,341000,None,1754000,-28900000,1200000,5489000,-30068000,-30000000,-23400000,-21646000,-30100000,2014Q4
38,USD,129624000,178252000,170849000,48607000,-25448000,122242000,32830000,155072000,None,-1848000,None,1848000,None,-5560000,None,1658000,-32891000,-833000,1848000,-32058000,-32283000,-31043000,-29385000,-32058000,2014Q3
39,USD,110990000,150700000,148242000,39710000,-145732000,107712000,27837000,256722000,272000,-13000,None,13000,None,417000,None,820000,-145315000,1272000,13000,-146587000,-146569000,-145302000,-144482000,-146587000,2014Q2
40,USD,103564000,141068000,154241000,37504000,-37156000,116467000,24253000,140720000,187000,-14000,None,14000,None,-184000,None,270000,-37340000,2606000,14000,-39946000,-39908000,-37326000,-37056000,-39946000,2014Q1
41,USD,94373000,128180000,115298000,33807000,-7011000,81491000,19893000,101384000,160000,-8000,None,8000,None,397000,None,155000,-6614000,1247000,8000,-7861000,-7840000,-6606000,-6451000,-7861000,2013Q4
42,USD,82127000,112385000,101641000,30258000,-6883000,71383000,17627000,89010000,137000,-9000,None,9000,None,5000,None,57000,-6878000,8958000,9000,-15836000,-15875000,-6869000,-6812000,-15836000,2013Q3
43,USD,73599000,101289000,91691000,27690000,-6450000,64001000,16048000,80049000,133000,-18000,None,18000,None,-24000,None,42000,-6474000,808000,18000,-7282000,-7248000,-6456000,-6414000,-7282000,2013Q2
44,USD,68881000,96499000,83161000,27618000,-2157000,55543000,15495000,71038000,116000,-7000,None,7000,None,56000,None,13000,-2101000,512000,7000,-2613000,-2597000,-2094000,-2081000,-2613000,2013Q1
45,USD,61744000,85934000,75753000,24190000,-3131000,51563000,13312000,64875000,98000,-40000,None,40000,None,-72000,None,2053000,-3203000,312000,40000,-3515000,-3542000,-3163000,-908000,-3515000,2012Q4
46,USD,54075000,75642000,21567000,21567000,-4244000,8852000,11746000,58319000,None,None,None,66000,None,None,None,1941000,-4310000,289000,None,None,-4599000,-4244000,-4167000,-4599000,2012Q3
47,USD,47067000,65700000,18633000,18633000,-41000,6430000,10462000,47108000,None,None,None,None,None,None,None,1719000,-41000,-837000,None,None,796000,-41000,1678000,796000,2012Q2
48,USD,41170000,56683000,15513000,15513000,1276000,5768000,8514000,39894000,None,None,None,564000,None,None,None,1324000,712000,288000,None,None,424000,1276000,2600000,424000,2012Q1
49,USD,42273000,57113000,14840000,14840000,6900000,5157000,7848000,35373000,None,None,None,462000,None,None,None,1150000,6438000,2322000,None,None,4116000,6900000,8514000,4116000,2011Q4
